1111111111111
1001C000000C1
10C0011111001
1P0001E000001
1111111111111